[
    {
      "id": 0,
      "name": "Classic 2-player",
      "map_data": [
        [2, 2, 0, 0, 0, 0, 0, 0, 0, 0, 0, 0, 0],
        [2, 1, 0, 1, 0, 1, 0, 1, 0, 1, 0, 1, 0],
        [0, 0, 0, 0, 0, 0, 0, 0, 0, 0, 0, 0, 0],
        [0, 1, 0, 1, 0, 1, 0, 1, 0, 1, 0, 1, 0],
        [0, 0, 0, 0, 0, 0, 0, 0, 0, 0, 0, 0, 0],
        [0, 1, 0, 1, 0, 1, 0, 1, 0, 1, 0, 1, 0],
        [0, 0, 0, 0, 0, 0, 0, 0, 0, 0, 0, 0, 0],
        [0, 1, 0, 1, 0, 1, 0, 1, 0, 1, 0, 1, 0],
        [0, 0, 0, 0, 0, 0, 0, 0, 0, 0, 0, 0, 0],
        [0, 1, 0, 1, 0, 1, 0, 1, 0, 1, 0, 1, 0],
        [0, 0, 0, 0, 0, 0, 0, 0, 0, 0, 0, 0, 0],
        [0, 1, 0, 1, 0, 1, 0, 1, 0, 1, 0, 1, 2],
        [0, 0, 0, 0, 0, 0, 0, 0, 0, 0, 0, 2, 2]
      ]
    },
    
    {
      "id": 1,
      "name": "Classic 4-player",
      "map_data": [
        [2, 2, 0, 0, 0, 0, 0, 0, 0, 0, 0, 2, 2],
        [2, 1, 0, 1, 0, 1, 0, 1, 0, 1, 0, 1, 2],
        [0, 0, 0, 0, 0, 0, 0, 0, 0, 0, 0, 0, 0],
        [0, 1, 0, 1, 0, 1, 0, 1, 0, 1, 0, 1, 0],
        [0, 0, 0, 0, 0, 0, 0, 0, 0, 0, 0, 0, 0],
        [0, 1, 0, 1, 0, 1, 0, 1, 0, 1, 0, 1, 0],
        [0, 0, 0, 0, 0, 0, 0, 0, 0, 0, 0, 0, 0],
        [0, 1, 0, 1, 0, 1, 0, 1, 0, 1, 0, 1, 0],
        [0, 0, 0, 0, 0, 0, 0, 0, 0, 0, 0, 0, 0],
        [0, 1, 0, 1, 0, 1, 0, 1, 0, 1, 0, 1, 0],
        [0, 0, 0, 0, 0, 0, 0, 0, 0, 0, 0, 0, 0],
        [2, 1, 0, 1, 0, 1, 0, 1, 0, 1, 0, 1, 2],
        [2, 2, 0, 0, 0, 0, 0, 0, 0, 0, 0, 2, 2]
      ]
    }
]